1111111111111111111111111111111111
1P  X  1C        1 CX 1    1    C1
1C   1 111111  1 1    111 11    11
1 1111 1X   1  1C1C  C  111   1  1
1    1 1    11   111 11   1C 11  1
1C1111   1    C  1 C 1    1111C  1
1 1    1 111111111   1  1  C1   11
1 111C 1         1   1 11   1 1  1
1 1 CC 111111111 11 11 1  111 1 C1
1C1 1          1  1 1  1  1   1111
1 111111   1 X 1  1 1 11E 1      1
1   C  11111 1 1    1 C1111111 1 1
1C  1  1 C 1C1 1 11111111C    C  1
11111  11  1 1 111  C X    1  1  1
1X C    C    1     11   1  1  1CC1
1111111111111111111111111111111111
