11111111
100X00C1
1000X001
11111011
1P0C00E1
11111111
