1111111111111
1001000000001
10X00111110X1
1P0011E0000C1
1111111111111
