11111111111111111111111111111111111111111111
1000111C111000100010C000000C1C0000C000100001
1C10000000001C101000001110001110011100001C01
11111110111111101010C0000000000000C100101101
1000001C00000000101011101110111C000100100001
10111011111111100010000000001P11110000101101
100E1000000000001C101C101C10100000000C100C01
11111111111111111111111111111111111111111111
